/bufferName	list: [string: "3137-Audio"]
/mapGain/active	float: 0
/mapGain/namespacebrowser/address	string: "none"
/mapGain/namespacebrowser/front	float: 0
/mapGain/namespacebrowser/local_receive	string: ""
/mapGain/namespacebrowser/origin	vec2f: [0, 0]
/mapGain/scalebypass	float: 0
/mapGain/function/parameters/1_name	string: ""
/mapGain/function/parameters/1_value	float: 0
/mapGain/function/parameters/2_name	string: ""
/mapGain/function/parameters/2_value	float: 0
/mapGain/function/parameters/curveList	list: []
/mapGain/input/max	float: 0
/mapGain/input/min	float: 0
/mapGain/output/max	float: 0
/mapGain/output/min	float: 0
/mapGain/process/function	string: "freehand"
/mapGain/process/clipmode	string: "both"
/mapGain/process/mode	float: 0
/mapGain/process/rampTime	float: 0
/mapGain/slide/down	float: 0
/mapGain/slide/up	float: 0
/mapGain.1/active	float: 0
/mapGain.1/namespacebrowser/address	string: "none"
/mapGain.1/namespacebrowser/front	float: 0
/mapGain.1/namespacebrowser/local_receive	string: ""
/mapGain.1/namespacebrowser/origin	vec2f: [0, 0]
/mapGain.1/scalebypass	float: 0
/mapGain.1/function/parameters/1_name	string: ""
/mapGain.1/function/parameters/1_value	float: 0
/mapGain.1/function/parameters/2_name	string: ""
/mapGain.1/function/parameters/2_value	float: 0
/mapGain.1/function/parameters/curveList	list: []
/mapGain.1/input/max	float: 0
/mapGain.1/input/min	float: 0
/mapGain.1/output/max	float: 0
/mapGain.1/output/min	float: 0
/mapGain.1/process/function	string: "freehand"
/mapGain.1/process/clipmode	string: "both"
/mapGain.1/process/mode	float: 0
/mapGain.1/process/rampTime	float: 0
/mapGain.1/slide/down	float: 0
/mapGain.1/slide/up	float: 0
/mapOnsetVar/active	float: 0
/mapOnsetVar/namespacebrowser/address	string: "none"
/mapOnsetVar/namespacebrowser/front	float: 0
/mapOnsetVar/namespacebrowser/local_receive	string: ""
/mapOnsetVar/namespacebrowser/origin	vec2f: [0, 0]
/mapOnsetVar/scalebypass	float: 0
/mapOnsetVar/function/parameters/1_name	string: ""
/mapOnsetVar/function/parameters/1_value	float: 0
/mapOnsetVar/function/parameters/2_name	string: ""
/mapOnsetVar/function/parameters/2_value	float: 0
/mapOnsetVar/function/parameters/curveList	list: []
/mapOnsetVar/input/max	float: 0
/mapOnsetVar/input/min	float: 0
/mapOnsetVar/output/max	float: 0
/mapOnsetVar/output/min	float: 0
/mapOnsetVar/process/function	string: "freehand"
/mapOnsetVar/process/clipmode	string: "both"
/mapOnsetVar/process/mode	float: 0
/mapOnsetVar/process/rampTime	float: 0
/mapOnsetVar/slide/down	float: 0
/mapOnsetVar/slide/up	float: 0
/mapPitch/active	float: 0
/mapPitch/namespacebrowser/address	string: "none"
/mapPitch/namespacebrowser/front	float: 0
/mapPitch/namespacebrowser/local_receive	string: ""
/mapPitch/namespacebrowser/origin	vec2f: [0, 0]
/mapPitch/scalebypass	float: 0
/mapPitch/function/parameters/1_name	string: ""
/mapPitch/function/parameters/1_value	float: 0
/mapPitch/function/parameters/2_name	string: ""
/mapPitch/function/parameters/2_value	float: 0
/mapPitch/function/parameters/curveList	list: []
/mapPitch/input/max	float: 0
/mapPitch/input/min	float: 0
/mapPitch/output/max	float: 0
/mapPitch/output/min	float: 0
/mapPitch/process/function	string: "freehand"
/mapPitch/process/clipmode	string: "both"
/mapPitch/process/mode	float: 0
/mapPitch/process/rampTime	float: 0
/mapPitch/slide/down	float: 0
/mapPitch/slide/up	float: 0
/mapPosition/active	float: 0
/mapPosition/namespacebrowser/address	string: "none"
/mapPosition/namespacebrowser/front	float: 0
/mapPosition/namespacebrowser/local_receive	string: ""
/mapPosition/namespacebrowser/origin	vec2f: [0, 0]
/mapPosition/scalebypass	float: 0
/mapPosition/function/parameters/1_name	string: ""
/mapPosition/function/parameters/1_value	float: 0
/mapPosition/function/parameters/2_name	string: ""
/mapPosition/function/parameters/2_value	float: 0
/mapPosition/function/parameters/curveList	list: []
/mapPosition/input/max	float: 0
/mapPosition/input/min	float: 0
/mapPosition/output/max	float: 0
/mapPosition/output/min	float: 0
/mapPosition/process/function	string: "freehand"
/mapPosition/process/clipmode	string: "both"
/mapPosition/process/mode	float: 0
/mapPosition/process/rampTime	float: 0
/mapPosition/slide/down	float: 0
/mapPosition/slide/up	float: 0
/mapPvar/active	float: 0
/mapPvar/namespacebrowser/address	string: "none"
/mapPvar/namespacebrowser/front	float: 0
/mapPvar/namespacebrowser/local_receive	string: ""
/mapPvar/namespacebrowser/origin	vec2f: [0, 0]
/mapPvar/scalebypass	float: 0
/mapPvar/function/parameters/1_name	string: ""
/mapPvar/function/parameters/1_value	float: 0
/mapPvar/function/parameters/2_name	string: ""
/mapPvar/function/parameters/2_value	float: 0
/mapPvar/function/parameters/curveList	list: []
/mapPvar/input/max	float: 0
/mapPvar/input/min	float: 0
/mapPvar/output/max	float: 0
/mapPvar/output/min	float: 0
/mapPvar/process/function	string: "freehand"
/mapPvar/process/clipmode	string: "both"
/mapPvar/process/mode	float: 0
/mapPvar/process/rampTime	float: 0
/mapPvar/slide/down	float: 0
/mapPvar/slide/up	float: 0
/mapSize/active	float: 0
/mapSize/namespacebrowser/address	string: "none"
/mapSize/namespacebrowser/front	float: 0
/mapSize/namespacebrowser/local_receive	string: ""
/mapSize/namespacebrowser/origin	vec2f: [0, 0]
/mapSize/scalebypass	float: 0
/mapSize/function/parameters/1_name	string: ""
/mapSize/function/parameters/1_value	float: 0
/mapSize/function/parameters/2_name	string: ""
/mapSize/function/parameters/2_value	float: 0
/mapSize/function/parameters/curveList	list: []
/mapSize/input/max	float: 0
/mapSize/input/min	float: 0
/mapSize/output/max	float: 0
/mapSize/output/min	float: 0
/mapSize/process/function	string: "freehand"
/mapSize/process/clipmode	string: "both"
/mapSize/process/mode	float: 0
/mapSize/process/rampTime	float: 0
/mapSize/slide/down	float: 0
/mapSize/slide/up	float: 0
/mapSpeed/active	float: 0
/mapSpeed/namespacebrowser/address	string: "none"
/mapSpeed/namespacebrowser/front	float: 0
/mapSpeed/namespacebrowser/local_receive	string: ""
/mapSpeed/namespacebrowser/origin	vec2f: [0, 0]
/mapSpeed/scalebypass	float: 0
/mapSpeed/function/parameters/1_name	string: ""
/mapSpeed/function/parameters/1_value	float: 0
/mapSpeed/function/parameters/2_name	string: ""
/mapSpeed/function/parameters/2_value	float: 0
/mapSpeed/function/parameters/curveList	list: []
/mapSpeed/input/max	float: 0
/mapSpeed/input/min	float: 0
/mapSpeed/output/max	float: 0
/mapSpeed/output/min	float: 0
/mapSpeed/process/function	string: "freehand"
/mapSpeed/process/clipmode	string: "both"
/mapSpeed/process/mode	float: 0
/mapSpeed/process/rampTime	float: 0
/mapSpeed/slide/down	float: 0
/mapSpeed/slide/up	float: 0
/mapSpread/active	float: 0
/mapSpread/namespacebrowser/address	string: "none"
/mapSpread/namespacebrowser/front	float: 0
/mapSpread/namespacebrowser/local_receive	string: ""
/mapSpread/namespacebrowser/origin	vec2f: [0, 0]
/mapSpread/scalebypass	float: 0
/mapSpread/function/parameters/1_name	string: ""
/mapSpread/function/parameters/1_value	float: 0
/mapSpread/function/parameters/2_name	string: ""
/mapSpread/function/parameters/2_value	float: 0
/mapSpread/function/parameters/curveList	list: []
/mapSpread/input/max	float: 0
/mapSpread/input/min	float: 0
/mapSpread/output/max	float: 0
/mapSpread/output/min	float: 0
/mapSpread/process/function	string: "freehand"
/mapSpread/process/clipmode	string: "both"
/mapSpread/process/mode	float: 0
/mapSpread/process/rampTime	float: 0
/mapSpread/slide/down	float: 0
/mapSpread/slide/up	float: 0
/mapTrigger/active	float: 0
/mapTrigger/namespacebrowser/address	string: "none"
/mapTrigger/namespacebrowser/front	float: 0
/mapTrigger/namespacebrowser/local_receive	string: ""
/mapTrigger/namespacebrowser/origin	vec2f: [0, 0]
/mapTrigger/scalebypass	float: 0
/mapTrigger/function/parameters/1_name	string: ""
/mapTrigger/function/parameters/1_value	float: 0
/mapTrigger/function/parameters/2_name	string: ""
/mapTrigger/function/parameters/2_value	float: 0
/mapTrigger/function/parameters/curveList	list: []
/mapTrigger/input/max	float: 0
/mapTrigger/input/min	float: 0
/mapTrigger/output/max	float: 0
/mapTrigger/output/min	float: 0
/mapTrigger/process/function	string: "freehand"
/mapTrigger/process/clipmode	string: "both"
/mapTrigger/process/mode	float: 0
/mapTrigger/process/rampTime	float: 0
/mapTrigger/slide/down	float: 0
/mapTrigger/slide/up	float: 0
/mapTurn/active	float: 0
/mapTurn/namespacebrowser/address	string: "none"
/mapTurn/namespacebrowser/front	float: 0
/mapTurn/namespacebrowser/local_receive	string: ""
/mapTurn/namespacebrowser/origin	vec2f: [0, 0]
/mapTurn/scalebypass	float: 0
/mapTurn/function/parameters/1_name	string: ""
/mapTurn/function/parameters/1_value	float: 0
/mapTurn/function/parameters/2_name	string: ""
/mapTurn/function/parameters/2_value	float: 0
/mapTurn/function/parameters/curveList	list: []
/mapTurn/input/max	float: 0
/mapTurn/input/min	float: 0
/mapTurn/output/max	float: 0
/mapTurn/output/min	float: 0
/mapTurn/process/function	string: "freehand"
/mapTurn/process/clipmode	string: "both"
/mapTurn/process/mode	float: 0
/mapTurn/process/rampTime	float: 0
/mapTurn/slide/down	float: 0
/mapTurn/slide/up	float: 0
/numChannels	int: 2
/scrubUI	float: 0.514583
/selection	vec2f: [110.29479, 337.02948]
/selection/mode	bool: false
/selection/range	list: [float: 110.29479, float: 337.02948]
/buffer/message	list: [string: "replace", string: "Macintosh HD:/Users/tml/Downloads/353194__inspectorj__wind-chimes-addtttss.wav"]
/file/ms	float: 25835.873
/file/open	string: "Macintosh HD:/Users/tml/Downloads/353194__inspectorj__wind-chimes-addtttss.wav"
/file/size	list: [string: "0:0:25:835"]
/grain/duration	float: 60
/grain/onsetVar	float: 881
/grain/overlap	int: 0
/grain/trigger/freq	float: 20
/grain/trigger/lock	bool: false
/grain/trigger/mode	bool: false
/grain/trigger/note	int: 0
/grain/trigger/variance/on	bool: false
/grain/trigger/variance/gainVar/randomnessRate	float: 0
/grain/trigger/variance/gainVar/range	list: []
/grain/trigger/variance/rateVar/randomnessRate	float: 0
/grain/trigger/variance/rateVar/spread	float: 0
/mapperGate/gain	int: 0
/mapperGate/onsetVar	int: 0
/mapperGate/pitch	int: 0
/mapperGate/pitchVar	int: 0
/mapperGate/position	int: 0
/mapperGate/size	int: 0
/mapperGate/speed	int: 0
/mapperGate/spread	int: 0
/mapperGate/trigger	int: 0
/mapperGate/turn	int: 0
/mod/gain	float: 0
/mod/gain.1	float: 0
/mod/onsetVar	float: 0
/mod/pitch	float: 0
/mod/pitchVar	float: 0
/mod/position	float: 0
/mod/size	float: 0
/mod/speed	float: 0
/mod/spread	float: 0
/mod/trigger	float: 0
/mod/turn	float: 0
/modAmt/gain	float: 0
/modAmt/gain.1	float: 0
/modAmt/onsetVar	float: 0
/modAmt/pitch	float: 0
/modAmt/pitchVar	float: 0
/modAmt/position	float: 0
/modAmt/size	float: 0
/modAmt/speed	float: 0
/modAmt/spread	float: 0
/modAmt/trigger	float: 0
/modAmt/turn	float: 0
/pan/mode	bool: false
/pan/rate	float: 1
/pan/spread	float: 0
/pitch/transpose	float: 0
/pitch/variation	float: 0
/playback/speed	float: 0
/playback/direction	int: 0
/playback/position	float: 0.02008032
/waveform/display	list: [int: 0, int: -1]
/waveform/line	float: 337.02948
/waveform/normalize	float: 1
